000000001000001000000000
011110101011101010111100
010000100000000010000100
011110110111110110111100
000010000100010000100000
011110010101010100111100
000000010001000100000000
101101111101011111011010
000000010000000100000000
110111010110110101110110
000100000100010000010000
011101110111110111011100
000000010000000100000000
110111010111110101110110
110000000000000000000110
000110110101010110110000
010100010001000100010100
010001000111110001000100
010100010001000100010100
000110110101010110110000
110000000000000000000110
110101111101011111010110
000100000001000000010000