0000000110001100000000
0111110110101101111100
0100010000100001000100
0101010110101101010100
0100000100000100000100
0111010101110101011100
0000000000100000000000
1111110110101101111110
0000010000000001000000
0101010011011001010100
0000000010001000000000
1111110011111001111110
0000000000000000000000
0110110110101101101100
0000000100100100000000
0111010101110101011100
0100000100000100000100
0101010110101101010100
0100010000100001000100
0111110111111101111100
0000000000000000000000