000000001000000000
011011101011101100
000000000000000000
011010111110101100
000010001000100000
111011101011101110
111010000000101110
000000110110000000
111010100010101110
111010111110101110
000010000000100000
011000101010001100
001011101011101000
101000000000001010
000010011100100000
011111001001111100
000000000000000000
