00000000100000000
01101110101110110
00000000000000000
01101011111010110
00001000100010000
11101110101110111
11101000000010111
00000000000000000
11101000000010111
11101000000010111
00001011111010000
01100000100000110
00101110101110100
10100000000000101
00001001110010000
01111100100111110
00000000000000000
