000000011000110000000
011111011010110111110
010001000010000100010
010101011010110101010
010000010000010000010
011101010111010101110
000000000010000000000
111111011010110111111
000001000000000100000
010101001101100101010
000000001000100000000
111111001111100111111
000000000000000000000
011011011010110110110
000000010010010000000
011101010111010101110
010000010000010000010
010101011010110101010
010001000010000100010
011111011111110111110
000000000000000000000