00000000100000100000000
01111010101110101011110
01000010000000001000010
01111011011111011011110
00001000010001000010000
01111001010101010011110
00000001000100010000000
10110111110101111101101
00000001000000010000000
11011101011011010111011
00010000010001000001000
01110111011111011101110
00000001000000010000000
11011101011111010111011
11000000000000000000011
00011011010101011011000
01010001000100010001010
01000100011111000100010
01010001000100010001010
00011011010101011011000
11000000000000000000011
11010111110101111101011
00010000000100000001000